11111111111111111
1P100000011000011
100000E1000C11111
11111111111111111
