11111111111111111
1P1000CC011000011
1000111100C011E11
11111111111111111